10
10
####S#####
####.#####
####...###
######.###
##.....###
##.#######
##.....###
######.###
######.###
######D###
