15
15
########S######
########...####
##########..###
###########.###
#####....##.###
#####.##.##.###
####..##..#.###
###..####...###
###.###########
###......######
########..#####
####....#.#####
####.##...#####
####..#########
#####...D######
